NO ./assets/xpm/BRICK.xpm
SO ./assets/xpm/HEDGE.xpm
WE ./assets/xpm/BRICK_G.xpm
EA ./assets/xpm/BRICK_GS.xpm

F 110,153,15
C 129,213,255

11111111111111111111111
10000000000000000000001
10110001110011111000101
10110001110011111000101
10110000000511111000101
10000000000000000000001
10000N00000000000000001
10000000000000000000001
11111111111111111111111
