1111111111111111111111111
1000000000110000000000001
1011000001110000000000001
1001000000000000000000001
1111011111111101110000001
1111011111111101110101001
1100000011010101110000001
1000000000000000110000001
1000N00000000000110101001
1100000111010101111101111
1111111111111111111111111