NO ./assets/xpm/BRICK.xpm
SO ./assets/xpm/HEDGE.xpm
WE ./assets/xpm/BRICK_G.xpm
EA ./assets/xpm/BRICK_GS.xpm

F 110,153,15
C 255,255,255

1
11
101
1001
10001
10001
1N001
100001
1000011111
1000000001
100000011
11111111