NO ./assets/xpm/BRICK.xpm
SO ./assets/xpm/HEDGE.xpm
WE ./assets/xpm/BRICK_G.xpm
EA ./assets/xpm/BRICK_GS.xpm

F 110,153,15
C 129,213,255

111111111111111111111111111111111111111111111111111111111111
111111101111111111111111111111111111111111111111111111111111
111111101111111111111111111111111111111111111111111111111111
111111101111111111111111111111111111111111111111111111111111
111111101111100000001101111111111111100001111100000000001111
111111101111101111111101111111111111101111111101111111101111
111111101111101111111101111111111111101111111101111111101111
111111100000000000000001111111111111101111100001111101101111
111111101111111111101111111111111111101111101101111101101111
111111101111111111101111111111111111101111101101111101101111
111100001111111111101111111111111111101111101100001101101111
111101111111111111101111111111111111101111101111101101101111
111101111111111111101111111111111111101111101111101101101111
111101111101111100001111111111111111100000001111100001101111
111101111101111101101111111111111111101101101111111101101111
111101111101111101101111111111111111101101101111111101101111
1000000000011111000000011111111111111NN000110000000000000111
111101111111111111111101111111111111111101111101111111101111
111101111111111111111101111111111111111101111101111111101111
111100001111111111100001111111111111111101100000001100000001
111111101111111111101111111111111111111101101111111111101111
111111101111111111101111111111111111111101101111111111101111
111111100000000000001111111111111111111100000000001111100001
111111111111101111111111111101111111111101111111101111111101
111111111111101111111111111101111111111101111111101111111101
111111111111111111111111111111111111111111111111111111111111