NO ./assets/test.xpm
SO ./assets/test.xpm
WE ./assets/test.xpm
EA ./assets/test.xpm

F 255,206,109
C 129,213,255

1111111
1000001
100N001
1111111