11111111111111111111111
10000000000000000000001
10110001110011111000101
10110001110011111000101
10110000000011111000101
10000000000000000000001
10110000111000111110001
10110000111000111000001
10110000111000111100001
10000000111000111100001
1000N000000000000000001
11111111111111111111111