11111111111111111111111
10000000000000000000001
10110001110011111000101
10110001110011111000101
10110000000011111000101
10000000000000000000001
10110111111100111110001
10110111011100111000001
10110111011100111100001
10000111011100111100001
100N0000000000000000001
11111111111111111111111