11111111111111111111111
10000000000000000000001
10110001110011111000101
10110001110011111000101
10110000000011111000101
10000000000000000000001
10000000000000000000001
10000000000000000000001
10000000000000000000001
100000N0000000000000001
10000000000000000000001
10000000000000000000001
10000000000000000000001
10000000000000000000001
11111111111111111111111