NO ./assets/brick.xpm
SO ./assets/debug.xpm
WE ./assets/furnace.xpm
EA ./assets/tnt.xpm

F 255,206,109
C 129,213,255

11111111111111111111111
1S000000000000000000001
10110001110011111000101
10110001110011111000101
10110000000011111000101
10000000000000000000001
10000000000000000000001
10000000000000000000101
10000000000000000000001
10000000000000000000001
10000000000000000000001
10000000000000000000001
10000000000000000000001
10000000000000000000001
11111111111111111111111