111111111111111111111111111111111
100000000000000011100000000000001
10E000000000000000000000000000001
100000000000000011100000000000001
111111111111111111111111111111111